####################
# # #   # #   #  # #
#-     # # # #   # #
# ##  # # # ##  #  #
#  #### # #  #  #  #
#  #  ###   ###    #
#  #            #  #
#  # # ##  #    ####
#  ###  #  # #  #  #
#   #   ####    #  #
#   ### #  #   #####
#               #  #
#  #  ###   ####  ##
#  #  #   # ##    ##
#  #  # #+#       ##
#  #    #       #  #
#  #  ####  #      #
#  ####  ####  ##  #
#            #  #  #
####################