####################
# # #   # #  ####  #
#     # # # #   #  #
####  # #-# ##  #  #
#  #    # #  #  #  #
#  #  ###   ###    #
#  #            #  #
#  # # ##  #    ####
#  ###  #  #    #  #
#   #   ####       #
#   ### #  #   #####
#       #  #    #  #
#     ###   ###    #
#     #   #     ####
#     # # #        #
#  #    #       #  #
#  #    ####  #   ##
#  ####  ####  ##  #
# +#         #  #  #
####################