####################
#                  #
#  #  #######   #  #
#  #  # # # #   # -#
#  #    # # #   ####
#  #  ###   ###    #
#  #            #  #
#  ######  #    ####
#       #  #    #  #
#  ##   ####       #
#   #####  #   #####
#       #  #       #
####  ###  ####    #
#     #         ####
#     #####        #
#  #    # +     #  #
#  #    ####    ####
#  ####  ####   #  #
#  #        #   #  #
####################