##############################
#                      #  #  #
#  #  #######   #  #####  #  #
#  #  # # # #   # -#      #  #
#  #    # # #   ####    ###  #
#  #  ### # ###    #         #
#  #      #     #          ###
#  ######       ########     #
#       #          #   #     #
#       ####       #   #  ####
#   #####  #   #####   #  #  #
#       #  #       #   #  #  #
####  ###  ####    #  ##  #  #
#     #         ####         #
#  #  #####        #  ####   #
#  #            #  #       # #
#  #            ####### #  # #
#  ##########   #       #  # #
#           #   #  #    #  # #
#########   #   ####    ######
#       #   #                #
#   # # #   #   #####  #     #
#   # ###   #   #   #  #     #
#   #       #   #   #  #     #
#   ####        #   ####     #
#  +   #                     #
######## #####     ##   ###  #
#        #   #    # #   #    #
#        #       #      #    #
##############################