##############################
#                      #  #  #
#  #  #######   #  #####  #  #
#  #  # # # #   #  #      #  #
#  #    # # #   ####    ###  #
#  #  ### # ###    #    #   ##
#  #            #       #  ###
#  ##  ##       ########   # #
#  #    #  #       #   #   # #
#  #    ####       #   #   ###
#    #### +#   #####   #  #  #
#       #  #       #   #  #  #
####  ###  ####    #  ##  #  #
#     #    #    #####        #
#  #  #    #        #     #  #
#  ####    ##   #        ##  #
#  #            #######      #
#  ##########   #       #  # #
#           #   #  #    #  # #
########    ##################
#           #   #            #
#  ######   #   #  ####    ###
#  #        #   #####      # #
#      ###     ##   #      # #
#                   #      # #
#  ###     ###      #  ##### #
#    #        ####  #        #
#    ######      #     #######
#    #  -        #           #
##############################