##############################
#  #  #-        ##      # #  #
#  #  #######   #  #####  #  #
#  #  #     #   #         #  #
#  #      ###   ####    ###  #
#  #  ###   ###    #    #   ##
#  #            #       #  ###
#  ##  ##    #  ########   # #
#  #    #  # #     #   #   # #
#  #    #### #     #   #   # #
#    ####  #   #####   #  #  #
#       #          #   #  #  #
####  ###  ####    #  ##  #  #
#     #    #    #####        #
#  #  #  # #        ###   ####
#  ####  # ##   #         #  #
#  #     #      #######   #  #
#  ##########   #       #    #
#           #   #  #    #    #
#######  ####   #   #   ######
# #         #   #    #       #
# ##       #    #    #       #
# # #      #    #    #   #####
# #  #    #     #    #       #
# #   #  #              #    #
# #          ######  +  #    #
# ######  #    #        #    #
#      #  ######  #######    #
#  ##     #             #    #
##############################