########################################
#  #  #-        ##      # #  #
#  #  #######   #  #####  #  #
#  #  #     #   #         #  #
#  #      ###   ####    ###  #
#  #  ###   ###    #    #   ##
#  #            #       #  ###
#  ##  ##    #  ########   # #
#  #    #  # #     #   #   # #
#  #    #### #     #  +#   # #
#    ####  #   #####   #  #  #
#       #          #   #  #  #
####  ###  ####    #  ##  #  #
#     #    #    #####        #
#  #  #  # #        ###   ####
#  ####  # ##   #         #  #
#  #     #      #######   #  #
#  ##########   #       #    #
#           #   #       #    #
########################################